PDT Partners	Software Engineering Internship	NYC
Sensata Technologies	Software Engineer Intern	Attleboro, MA
Weave	Data Engineer Intern	Lehi, UT
Charles Schwab	Internship - 2024 Charles Schwab Software Engineering	Multiple
PwC	Data Platform Engineering Intern - Summer 2024	<details><summary>**65 locations**</summary>Birmingham, AL</br>Fayetteville, AR</br>Little Rock, AR</br>Phoenix, AZ</br>Irvine, CA</br>Los Angeles, CA</br>Sacramento, CA</br>San Diego, CA</br>San Francisco, CA</br>Silicon Valley, CA</br>Denver, CO</br>Hartford, CT</br>Stamford, CT</br>Washington, DC</br>Hallandale Beach/Miami, FL</br>Jacksonville, FL</br>Orlando, FL</br>Tampa, FL</br>West Palm Beach, FL</br>Atlanta, GA</br>Des Moines, IA</br>Chicago, IL</br>Indianapolis, IN</br>Louisville, KY</br>New Orleans, LA</br>Boston, MA</br>Baltimore, MD</br>Detroit, MI</br>Grand Rapids, MI</br>Minneapolis, MN</br>Kansas City, MO</br>St. Louis, MO</br>Charlotte, NC</br>Greensboro, NC</br>Raleigh, NC</br>Florham Park, NJ</br>Las Vegas, NV</br>Albany, NY</br>Buffalo, NY</br>Melville, NY</br>New York, NY</br>Rochester, NY</br>Cincinnati, OH</br>Cleveland, OH</br>Columbus, OH</br>Toledo, OH</br>Oklahoma City, OK</br>Tulsa, OK</br>Portland, OR</br>Philadelphia, PA</br>Pittsburgh, PA</br>Columbia, SC</br>Spartanburg, SC</br>Nashville, TN</br>Austin, TX</br>Dallas, TX</br>Fort Worth, TX</br>Houston, TX</br>San Antonio, TX</br>Salt Lake City, UT</br>Richmond, VA</br>Montpelier, VT</br>Seattle, WA</br>Milwaukee, WI</br>Remote in USA</details>
Tradeweb	C++ Developer - Summer 2024 internship	Jersey City, NJ
Lumen Technologies	Internship program (Express Interest) (U.S. work authorization required)	Remote, USA
Intuit	Summer Internship Interest	Multiple Locations
Bayer	Software Engineer Intern	Creve Coeur, MO
Tenstorrent	ML Intern – Customer Team	Austin, TX
DRW	Site Reliability Engineer Intern	Austin, TX Chicago, IL
Cambly	Software Engineering Internship - Summer 2024	SF
Palantir	Software Engineer – Internship	Seattle, WA
Chime	Data Analytics Intern	SF
Belvedere Trading	Software Engineer Intern - Summer 2024 Chicago	Chicago, IL
Five Rings	Software Dev Intern	NYC
Stripe	Software Engineering Intern	Seattle, WA</br>SF</br>NYC
Capital One	Technology Internship Program	<details><summary>**10 locations**</summary>Cambridge, MA</br>SF</br>Philadelphia, PA</br>Plano, TX</br>McLean, VA</br>Richmond, VA</br>Chicago, IL</br>NYC</br>Roswell, GA</br>Wilmington, DE</details>
Figma	Software Engineer Intern - 2024	SF</br>NYC
Arrowstreet Capital	Quantitative Developer Intern - Summer 2024	Remote
D.E. Shaw	Software Development Intern	NYC
Oshkosh Corporation	Computer/Software Engineering Intern	Oshkosh, WI
Rivian	Data Engineering and Analytics – Summer 2024 Internships	Irvine, CA
Bank of America	Global Technology Summer Analyst Program	<details><summary>**10 locations**</summary>Addison, TX</br>Charlotte, NC</br>Chicago, IL</br>Denver, CO</br>Pennington, NJ</br>Plano, TX</br>Richardson, TX</br>Washington, DC</br>Richmond, VA</br>NYC Metro, NY</details>
Milliman	Software Engineer Intern	Omaha, NE
Connor Group	2024 Digital Solutions Intern	United States
Nomura	Information Technology Summer Analyst Program	NYC
D.E. Shaw	Systems Technologist Intern	NYC
Mosaic ML	Research Scientist Intern	SF</br>NYC
Google	Software Engineering Intern (MS)	Multiple US Locations
Point72	Quantitative Developer Internship	NYC
Jane Street	Software Engineer Internship	NYC
Datadog	Software Engineering Intern	New York City, NY
D.E. Shaw	Systems Technical Program Manager Intern	NYC
Radix Trading	C++ Quantitative Technologist Intern	Chicago, IL
Crestron	Internship Program	Plano, TX</br>Rockleigh, NJ
Salesforce	Summer 2024 Intern - Data Science - Data & Analytics	Indianapolis, IN</br>Dallas, TX</br>Atlanta, GA
Cisco	Software Engineer II Intern	Multiple Locations
IMC Trading	Software Engineer Intern	Chicago, IL
Akuna Capital	Software Engineer Intern - C++	Chicago, IL
Capstone Investment Advisors	Software Engineer Intern	NYC
Maximus	Software Engineer Intern	Mclean, VA
DoorDash	Software Engineer – Intern - Summer 2024	<details><summary>**4 locations**</summary>Seattle, WA</br>SF</br>LA</br>NYC</details>
SIG	Software Engineering Internship Program (Express Interest)	Bala Cynwyd, PA
Royal Bank of Canada	Quantitative Technology Services Intern	Jersey City, NJ
Internet Brands	Intern Software Engineer	Los Angeles, California
Okta	Software Engineer Intern - Summer 2024	United States
Epic Games	Physics Programmer Intern	Morrisville, NC
Verkada	Software Engineering Intern - Backend - Summer 2024	San Mateo, CA
Amazon	Software Development Engineer Internship	Seattle, WA
Optiver US	Software Engineer Intern	Chicago, IL
DRW	Software Developer Intern	Austin, TX</br>Chicago, IL
Jump Trading	Campus Software Engineer – Intern	Chicago, IL
Athelas	Software Engineer Intern	Mountain View, CA
Akuna Capital	Quantitative Development Internship	Chicago, IL
HRL Laboratories	Natural Language Processing Intern	Calabasas, CA
TikTok	Software Engineer Intern (Anti Automation Solutions)	San Jose</br>US
Snap Inc.	Software Engineering Intern	Palo Alto, CA</br>Seattle, WA</br>Los Angeles, CA
Scholastic	Scholastic Summer Software Engineer Intern	NYC
US Bank	2024 Software Engineering Summer Intern	Richfield, MN</br>Atlanta, GA
Docugami	Software Engineering Intern	Kirkland, WA
Morgan Stanley	Technology Summer Analyst Program	NYC
Oracle NetSuite	Software Engineer Intern	Redwood City, CA</br>Austin, TX
Oklahoma City Thunder	Software Engineer Intern Data Science And Solutions	Remote
Citadel	Software Engineer Intern	Chicago, IL</br>NYC
Databricks	Software Engineering Intern	Mountain View, CA</br>San Francisco, CA</br>Bellevue, WA
Caterpillar	Software Engineering Intern	Multiple Locations
Align Technology	Summer 2024 Internship (Expression of Interest)	Multiple Locations
